 CCCCCCCGGGGG
GSS CCCCCGGGG
    CC   GGGG
G GGSSC  GGGG
SSSSSS   GGGG
GG CC SSS CC 
   GG  SS G  
G G G G G G G